.
.
.
............................................................................@..............................
..........................................................................................................
##############################################################################.............################
#######################################################################....................################
##########################################################.......................###########################
################################################################.................##########################
######################################################.................####################################
#################################################.....................######################################
#######################################...................###################################################
######################################......###......######################################################
###########################..............#######..........##################################################
######################..................###########..............##########################################
#######################################################..........##########################################
############################################################....###########################################
#############################################################....##########################################
###############################################################....########################################
##############################################################.....########################################
###########################################################........########################################
#########################################################.........#########################################