.
.
.
............................................................................@..............................
..........................................................................................................
##############################################################################.............################
#######################################################################............########################
##########################################################...............##################################
################################################################.................##########################
######################################################.................####################################
#################################################........##################################################
##########################################........#########################################################
######################################......###......######################################################
###########################..............##########......##################################################
######################...........#######################.........##########################################
############################################################.....##########################################
############################################################....###########################################
#############################################################....##########################################
###############################################################....########################################
##############################################################.....########################################
###########################################################........########################################
#########################################################.........#########################################