........................................................................................................................
........................................................................................................................
........................................................................................................................
.................................................................................................................***....
....................................................................................................%%..........**/**...
....................................@..............................................................%{{%%.......***/***..
.................................................................................................%%{{{{#%........./.....
%%%%%%%^^^^^^^^^^^^^^^^^^^^^%%%%%%%%%%%%%%...............%%%%$$$$$$$$$$$$$$$$$$$$$$$$$$$$$$$%%%%%#{{{{{{#%%%%%%%%%%%%%%%
#####^^^^^^^^^^^^^^^^^^^^^^^^^##############............######$$$$$$$$$$$$$$$$$$$$$$$$$$$#######{{{{{{{{{###############
#######^^^^^^^^^^^^^^^^^^^^#################...........##########$$$$$$$$$$$$$$$$$$$$$########{{{{{{{{{{{{{#############
#########^^^^^^^^^^^^^^^^######################.....#################$$$$$$$$$$$$$$##########{{{{{{{{{{{{{{{{###########
##############^^^^^#############################..########################$$$$$$$$#######{{{{{{{{{{{{{{{{{{{{{{#########
##############################################################################$$$#####{{{{{{{{{{{{{{{{{{{{{{{{{{{{######
{{{{{{{{{{{{{{{{{{{{{{{{{{{{{{{{{{{{{{{{{{{..{{{{{{{{{{{{{{{{{{{{{{{{{{{{{{{{{{{{{{{{{{{{{{{{{{{{{{{{{{{{{{{{{{{{{{{{{{{
{{{{{{{{{{{{{{{{{{{{....{{{{{{{{{{{{{{{{......{{{{{{{{{{{{{{{{{{{{{{{{{{{{{{{{{{{{{{{{{{{{{{{{{{{{{{{{{{{{{{{{{{{{{{{{{{
{{{{{{{{{{{{{{{{{{{{{......{{{{{{{{{{{{{{....{{{{{{{{{{{{{{{{{{{{{{{{{{{{{{{{{{{{{{{{{{{{{{{{{{{{{{{{{{{{{{{{{{{{{{{{{{{
{{{{{{{{{{{{{{{{{{{{{{{{.......{{{{{{{{{{{.{{{{{{{{{{{{{{{{{{{{{{{{{{{{{{{{{{{{{{{{{{{{{{{{{{{{{{{{{{{{{{{{{{{{{{{{{{{{{
{{{{{{{{{{{{{{{{{{{{{{{{{{{.......{{{{{{{{{{{{{{{{{{{{{{{{{{{{{{{{{{{{{{{{{{{{{{{{{{{{{{{{{{{{{{{{{{{{{{{{{{{{{{{{{{{{{{
{{{{{{{{{{{{{{{{{{{{{{{{{{{{{{{{{{{{{{{{{{{{{{{{{{{{{{{{{{{{{{{{{{{{{{{{{{{{{{{{{{{{{{{{{{{{{{{{{{{{{{{{{{{{{{{{{{{{{{{{
{{{{{{{{{{{{{{{{{{{{{{{{{{{{{{{{{{{{{{{{{{{{{{{{{{{{{{{{{{{{{{{{{{{{{{{{[{{{{{{{{{{{{{{{{{{{{{{{{{{{{{{{{{{{{{{{{{{{{{{{