.....##...#..#
...##.#..##..#..
..#..#.###..####..
.....@...#...#####
...#...#...#....#
###############.#
................#
.################
...##############
##.##############
##.##############
##.........######
##########.######